15 15
S.X....KX...X..
.XXX.XXXXXXX.X.
.....X.....X..X
X.XX.XXX.XXX.X.
X...X.K..X...X.
X.XXX.XXX.X.XX.
X......X..G...X
X.XXX.XXX.XXX.X
X....X......K.X
X.XX.XXX.XXX.X.
X...X.G..X....X
X.XXX.XXX.XXX.X
X.............X
X.XXXXXXX.XXX.X
X.G...T.G......